ANTICLOCKWISE	AE N T AY K L AA K W AY Z
BACK	B AE K
BOTTLE	B AA T AH L
CLOCKWISE	K L AA K W AY Z
CLOSE	K L OW S
CLOSE(2)	K L OW Z
COMMAND	K AH M AE N D
DOWN	D AW N
FINISH	F IH N IH SH
FIRST	F ER S T
FRONT	F R AH N T
GRASP	G R AE S P
HOME	HH OW M
LEFT	L EH F T
LONG	L AO NG
MEDIUM	M IY D IY AH M
OPEN	OW P AH N
PICK	P IH K
POSITION	P AH Z IH SH AH N
RIGHT	R AY T
SECOND	S EH K AH N D
SIDE	S AY D
SMALL	S M AO L
THIRD	TH ER D
TOP	T AA P
TOP(2)	T AO P
UP	AH P
